R   640    640
NO    ../xpmsprites/wood.XPM
SO  ../xpmsprites/redbrick.XPM
WE ../xpmsprites/colorstone.XPM
EA     ../xpmsprites/bluestone.XPM

S     ../xpmsprites/barrel.XPM
F   220,  100,   0
C 225, 30,   0

1111111111111111
1111100011001111
1111000001000011
   1111002010101111
1111000000000001
1000000000000001
1000000000000001
1000000000000001
111000E001111011
1000100001111001
1000010110000001
1000110100001011
1111111111111111
